111111111
111000001
1P0C000E1
100001001
111111111
