111111111
111000001
1P0C0E001
100001001
111111111