1111111111111
1P11111111111
1011111111111
10000C00000E1
1111111111111